2001: A Space Odyssey	Arthur C. Clarke
A Ballad for Georg Henig	Viktor Paskov
A Bell for Adano	John Hersey
A Boy's Own Story	Edmund White
A Brief History of Seven Killings	Marlon James
A Canticle for Leibowitz	Walter M. Miller
A Confederacy of Dunces	John Kennedy Toole
A Constellation of Vital Phenomena: A Novel	Anthony Marra
A Dance to the Music of Time	Anthony Powell
A Day Off	Storm Jameson
A Death in the Family	James Agee
A Dog's Purpose	W. Bruce Cameron
A Dry White Season	Andre Brink
A Fan's Notes	Frederick Exley
A Feast of Snakes	Harry Crews
A Fine Balance	Rohinton Mistry
A Frolic of His Own	William Gaddis
A Game of Thrones	George R. R. Martin
A Good Scent from a Strange Mountain	Robert Olen Butler
A Hero of Our Time	Mikhail Lermontov
A High Wind in Jamaica	Richard Hughes
A Home at the End of the World	Michael Cunningham
A Kestrel for a Knave	Barry Hines
A Legacy	Sybille Bedford
A Lesson Before Dying	Ernest J. Gaines
A Light Comedy	Eduardo Mendoza
A Little Life	Hanya Yanagihara
A Little Princess	Frances Hodgson Burnett
A Mirror for Witches	Esther Forbes
A Pale View of Hills	Kazuo Ishiguro
A Place of Greater Safety	Hilary Mantel
A Question of Power	Bessie Head
A Reckless Character and Other Stories	Ivan Turgenev
A Sentimental Journey Through France and Italy	Laurence Sterne
A Separate Peace	John Knowles
A Series of Unfortunate Events #1: The Bad Beginning	Lemony Snicket
A Sight for Sore Eyes	Ruth Rendell
A Single Man	Christopher Isherwood
A Sport and a Pastime	James Salter
A Thousand Acres	Jane Smiley
A Thousand Splendid Suns	Khaled Hosseini
A Tomb for Boris Davidovich	Danilo Kiš
A Town Like Alice	Nevil Shute
A Tree Grows in Brooklyn	Betty Smith
A Violent Life	Pier Paolo Pasolini
A Visit From The Goon Squad	Jennifer Egan
A World for Julius	Alfredo Bryce Echenique
A Wrinkle In Time	Madeleine L'Engle
Absolute Beginners	Colin MacInnes
Abu Telfan, Return from the Mountains of the Moon	Wilhelm Karl Raabe
Adam Bede	George Eliot
Adolphe	Benjamin Constant
Advertisements for Myself	Norman Mailer
Advise and Consent	Allen Drury
Aesop's Fables	Aesop
Affliction	Russell Banks
African Stories	Doris Lessing
After the Flood	P. C. Jersild
Airships	Barry Hannah
Alamut	Vladimir Bartol
Alberta empfängt einen Liebhaber	Birgit Vanderbeke
Alcestis	Euripides
Alice Adams	Booth Tarkington
All about H. Hatterr	G. V. Desani
All Grown Up	Jami Attenberg
All My Puny Sorrows	Miriam Toews
All Quiet on the Western Front	Erich Maria Remarque
All the King's Men	Robert Penn Warren
All the Light We Cannot See	Anthony Doerr
Always Coming Home	Ursula K. Le Guin
Amadis of Gaul	Garci Rodriguez de Montalvo
Amelia	Henry Fielding
American Genius: A Comedy	Lynne Tillman
American Innovations	Rivka Galchen
American Psycho	Bret Easton Ellis
American Rust	Philipp Meyer
American War	Omar El Akkad
Amerika	Franz Kafka
Amers	Saint-John Perse
An Absolutely Remarkable Thing	Hank Green
An Enemy of the People	Henrik Ibsen
An Occurrence at Owl Creek Bridge	Ambrose Bierce
An Untamed State	Roxane Gay
Anagrams	Lorrie Moore
Ancestral Voices	Etienne van Heerden
Andersonville	MacKinlay Kantor
Anecdotes of Destiny	Isak Dinesen
Anil's Ghost	Michael Ondaatje
Anne of Green Gables	Lucy Maud Montgomery
Anniversaries	Uwe Johnson
Another Country	Karel Schoeman
Antiworlds	Andrey Voznesensky
Anton Reiser	Karl Philipp Moritz
Anything Is Possible	Elizabeth Strout
Apu Ollontay	Peru
Arcanum 17	André Breton
Around the World in Eighty Days	Jules Verne
Arrow of God	Chinua Achebe
Artemis Fowl	Eoin Colfer
As If I Am Not There	Slavenka Drakulic
Ashes and Diamonds	Jerzy Andrzejewski
Asterix the Gaul	Rene Goscinny
Astonishing the Gods	Ben Okri
Astradeni	Eugenia Fakinou
Asymmetry	Lisa Halliday
Aurélien	Louis Aragon
Aus dem Leben eines Taugenichts	Joseph von Eichendorff
Auto Da Fé	Elias Canetti
Autobiography of an Ex-Colored Man	James Weldon Johnson
Babbitt	Sinclair Lewis
Bad Behavior: Stories	Mary Gaitskill
Ballad of the Salt Sea	Hugo Pratt
Ballet Shoes	Noel Streatfeild
Balzac and the Little Chinese Seamstress	Dai Sijie
Barefoot	Zaharia Stancu
Bartleby & Co	Enrique Vila-Matas
Bastard Out of Carolina	Dorothy Allison
Bathsheba	Torgny Lindgren
Baudolino	Umberto Eco
Beat the Devil	Claud Cockburn
Bébo's Girl	Carlo Cassola
Been Down So Long it Looks Like Up to Me	Richard Fariña
Behind of the Scenes at the Museum	Kate Atkinson
Bel Ami	Guy de Maupassant
Belle du Seigneur	Albert Cohen
Ben-Hur	Lew Wallace
Benito Cereno	Herman Melville
Bérénice	Jean Racine
Berlin Alexanderplatz	Alfred Döblin
Betrayed	Rita Hayworth
Betty Blue: The Story of a Passion	Philippe Djian
Billy Liar	Keith Waterhouse
Billy Lynn's Long Halftime Walk: A Novel	Ben Fountain
Billy Phelan's Greatest Game	William Kennedy
Binocular Vision	Edith Pearlman
Birdsong	Sebastian Faulks
Black and Blur	Fred Moten
Black Beauty: The Autobiography of a Horse	Anna Sewell
Black Box	Amos Oz
Black Sheep	Georgette Heyer
Black Tickets	Jayne Anne Phillips
Black Water	Joyce Carol Oates
Blake and Mortimer	Edgar P. Jacobs
Bless Me, Ultima	Rudolfo Anaya
Blind Willow, Sleeping Woman	Haruki Murakami
Blood Tie	Mary Lee Settle
Body Rags	Galway Kinnell
Bohemian Lights	Ramón del Valle-Inclán
Bonfire of the Vanities	Tom Wolfe
Bonjour Tristesse	Francoise Sagan
Books of Blood	Clive Barker
Born Confused	Tanuja Desai Hidier
Born Yesterday	Gordon Burn
Bostan	Saadi
Bouvard et Pécuchet	Gustave Flaubert
Bowlaway	Elizabeth McCracken
Boy, Snow, Bird	Helen Oyeyemi
Bread Givers: A Novel : a Struggle Between a Father of the Old World and a Daughter of the New	Anzia Yezierska
Breakfast at Tiffany's	Truman Capote
Brick Lane	Monica Ali
Bridge to Terabithia	Katherine Paterson
Bridget Jones's Diary	Helen Fielding
Bright Lights, Big City	Jay McInerney
Broad and Alien is the World	Ciro Alegría
Broken Glass	Alain Mabanckou
Brooklyn	Colm Tóibín
Brown Girl, Brownstones	Paule Marshall
Building Stories	Chris Ware
Burmese Days	George Orwell
Busman’s Honeymoon	Dorothy L Sayers
Call It Sleep	Henry Roth
Calligrammes	Guillaume Apollinaire
Camera Obscura	Nicolaas Beets
Cancer Ward	Aleksandr Solzhenitsyn
Candida: a Pleasant Play	George Bernard Shaw
Candide	Voltaire
Cane	Jean Toomer
Capital	John Lanchester
Capital of Pain	Paul Éluard
Captain Hornblower R.N.: Hornblower and the 'Atropos', The Happy Return, A Ship of the Line	C S Forester
Carmen	Prosper Mérimée
Carry Me Down	M.J. Hyland
Carter Beats The Devil	Glen David Gold
Castle Gripsholm	Kurt Tucholsky
Castle Rackrent	Maria Edgeworth
Cat and Mouse	Günter Grass
Cat on a Hot Tin Roof	Tennessee Williams
Catch-22	Joseph Heller
Cat's Eye	Margaret Atwood
Celestial Harmonies	Peter Esterhazy
Celestina	Fernando de Rojas
Ceremony	Leslie Marmon Silko
Chaka	Thomas Mofolo
Chanda's Secrets	Allan Stratton
Charlotte's Web	E. B. White
Charming Billy	Alice McDermott
Cheese	Willem Elsschot
Chesapeake	James A. Michener
Chimera	John Barth
Christina Rossetti: The Complete Poems	Christina Georgina Rossetti
Christy	Catherine Marshall
Chronicle of a Death Foretold	Gabriel Garcia Marquez
Cider with Rosie	Laurie Lee
Circe	Madeline Miller
Cities of the Plain	Cormac McCarthy
Citizen: An American Lyric	Claudia Rankine
City of Bohane	Kevin Barry
City of Glass	Paul Auster
City of Salt	Abdelrahman Munif
City, Sister, Silver	Jáchym Topol
CivilWarLand in Bad Decline	George Saunders
Clear Light of Day	Anita Desai
Clockers	Richard Price
Close Range: Wyoming Stories	Annie Proulx
Closely Watched Trains	Bohumil Hrabal
Cloudstreet	Tim Winton
Cold Comfort Farm	Stella Gibbons
Cold Mountain	Charles Frazier
Cold Nights	Ba Jin
Cold Sassy Tree	Olive Ann Burns
Collected Poems	Wallace Stevens
Collected Poems	Allen Ginsberg
Collected Poems	Stéphane Mallarmé
Collected Poems	Nils Ferlin
Collected Poems	Jack Gilbert
Collected Poems	Jane Kenyon
Collected Poems 1912-1944	Hilda Doolittle
Collected Poems of Dylan Thomas	Dylan Thomas
Collected Poems of Frank O'Hara	Frank O'Hara
Collected Poems of Michael Donaghy	Michael Donaghy
Collected Poems of Ted Hughes	Ted Hughes
Collected Poems of W. B. Yeats	W. B. Yeats
Collected Short Stories of Saki	Saki
Collected Stories	William Somerset Maugham
Collected Stories of Peter Taylor	Peter Taylor
Commonwealth	Ann Patchett
Compassion	Benito Pérez Galdós
Complete Poems	Elizabeth Bishop
Complete Poems of Giacomo Leopardi	Giacomo Leopardi
Complete Stories	Dorothy Parker
Confessions of a Mask	Yukio Mishima
Confusion	Stefan Zweig
Contact	Carl Sagan
Conversations in Sicily	Elio Vittorini
Coplas por la muerte de su padre	Jorge Manrique
Corelli's Mandolin	Louis de Bernières
Cost	Roxana Robinson
Count Julian	Juan Goytisolo
Count Zero	William Gibson
Creamy and Delicious	Steve Katz
Crossfire	Miyuki Miyabe
Crow Lake	Mary Lawson
Cry, the Beloved Country	Alan Paton
Cutter and Bone	Newton Thornburg
Cutting for Stone	Abraham Verghese
Cyrano de Bergerac	Edmond Rostand
Dangerous Laughter	Steven Millhauser
Dangerous Liaison	Pierre Choderlos de Laclos
Daphnis and Chloe	Longus
Darconville's Cat	Alexander Theroux
Dark symphony: Negro literature in America	James A. Emanuel (Comp), Theodore L. Gross (Joint Comp)
Darkmans	Nicola Barker
Darkness at Noon	Arthur Koestler
Darkness Spoken: The Collected Poems	Ingeborg Bachmann
Dart	Alice Oswald
Dawn	Elie Wiesel
Day	A. L. Kennedy
De Rerum Natura	Lucretius
Dealing With Dragons	Patricia C. Wrede
Death in Rome	Wolfgang Koeppen
Death of a Lake	Arthur William Upfield
Death Of A Salesman	Arthur Miller
Death on Credit	Louis-Ferdinand Céline
Death Sentence	Maurice Blanchot
Decameron	Giovanni Boccaccio
Deep Rivers	José María Arguedas
Delicious Foods	James Hannaham
Deliverance	James Dickey
Demian	Hermann Hesse
Democracy	Joan Didion
Dept. of Speculation	Jenny Offill
Der Fall Mauritius	Jakob Wassermann
Devil in a Blue Dress	Walter Mosley
Dhalgren	Samuel R. Delany
Diamonds Are Forever	Ian Fleming
Diary of a Wimpy Kid	Jeff Kinney
Dictionary of the Khazars	Milorad Pavic
Die neuen Leiden des jungen W.	Ulrich Plenzdorf
Dirk Gently's Holistic Detective Agency	Douglas Adams
Dirty Havana Trilogy	Pedro Juan Gutierrez
Disappearance	David Dabydeen
Disobedience	Alberto Moravia
Dissolution: A Shardlake Novel	C. J. Sansom
Distant Star	Roberto Bolaño
Divine Secrets of the Ya-Ya Sisterhood	Rebecca Wells
Do Everything in the Dark	Gary Indiana
Docherty	William McIlvanney
Doctor Glas	Hjalmar Soderberg
Doctor Zhivago	Boris Pasternak
Dog	Kerstin Ekman
Dog Soldiers	Robert Stone
Dom Casmurro	Machado de Assis
Don Carlos: Infante of Spain, a Drama in Five Acts	Friedrich Schiller
Don Juan	Molière
Doña Bárbara	Rómulo Gallegos
Double Or Nothing	Raymond Federman
Down There	J. K. Huysmans
Dracula	Bram Stoker
Dragon's Teeth	Upton Sinclair
Dream of the Red Chamber	Cao Xueqin
Dreaming in Cuban	Cristina García
Dreamtigers	Jorge Luis Borges
Drive Your Plow Over the Bones of the Dead	Olga Tokarczuk
Drop City	T. Coraghessan Boyle
Drown	Junot Diaz
Drunkard	Émile Zola
Dune	Frank Herbert
Early Autumn	Louis Bromfield
Early Novels and Stories	James Baldwin
Earth Abides	George Rippey Stewart
Easy Travel to Other Planets	Ted Mooney
Eat the Document	Dana Spiotta
Eclipse of the Crescent Moon	Géza Gárdonyi
Ecotopia	Ernest Callenbach
Edmund Dulac's Fairy-Book	Edmund Dulac
Edward Lear's Book of Nonsense	Edward Lear
Effi Briest	Theodor Fontane
Eight Men: Short Stories	Richard Wright
Einstein's Dreams	Alan Lightman
El Buscón	Francisco de Quevedo
Elbow Room	James Alan McPherson
Elegies	Douglas Dunn
Eline Vere	Louis Couperus
Ellen Foster	Kaye Gibbons
Embers	Sandor Marai
Emily of New Moon	L. M. Montgomery
Empire Falls	Richard Russo
Empire of the Sun	J. G. Ballard
Ender's Game	Orson Scott Card
English Passengers	Matthew Kneale
Erasure	Percival Everett
Erewhon	Samuel Butler
Eugenie Grandet	Honoré de Balzac
Eustace and Hilda	L. P. Hartley
Eva Luna	Isabel Allende
Eva Trout	Elizabeth Bowen
Evelina	Fanny Burney
Every Man for Himself	Beryl Bainbridge
Everyman	Philip Roth
Everyman	Anonymous
Everything Begins and Ends at the Kentucky Club	Benjamin Alire Sáenz
Everything Ravaged, Everything Burned	Wells Tower
Everything That Rises Must Converge	Flannery O'Connor
Exercises in Style	Raymond Queneau
Exit West	Mohsin Hamid
Extremely Loud and Incredibly Close	Jonathan Safran Foer
Eye Of The Needle	Ken Follett
Fables of La Fontaine	Jean de La Fontaine
Faceless Killers	Henning Mankell
Faces In The Water	Janet Frame
Fado Alexandrino	António Lobo Antunes
Fairy Tales and Stories	Hans Christian Anderson
Falconer	John Cheever
Fall On Your Knees	Ann-Marie MacDonald
Falling in Place	Ann Beattie
Family Life	Akhil Sharma
Family Sayings	Natalia Ginzburg
Fanny Hill	John Cleland
Fantômas	Marcel Allain, Pierre Souvestre
Farewell, My Lovely: A Novel	Raymond Chandler
Fateless	Imre Kertész
Fates and Furies	Lauren Groff
Fear and Loathing in Las Vegas: A Savage Journey to the Heart of the American Dream	Hunter S. Thompson
Fear of Flying	Erica Jong
Ferdydurke	Witold Gombrowicz
Fifty Shades of Grey:	E L James
Finnegans Wake	James Joyce
Flatland: A Romance of Many Dimensions	Edwin A. Abbott
Fleshmarket Close	Ian Rankin
Flicker	Theodore Roszak
Flight Behavior	Barbara Kingsolver
Flowering Judas and Other Stories	Katherine Anne Porter
Flowers in the Attic	V. C. Andrews
Foliage: Or, Poems Original and Translated	Leigh Hunt
Follow the River	James Alexander Thom
Fool's Gold	Máro Doýka
Fools of Fortune	William Trevor
Foreign Affairs	Alison Lurie
Forest of the Hanged	Liviu Rebreanu
Forever a Stranger	Hella S. Haasse
Forever...	Judy Blume
Forever: A Novel	Pete Hamill
Fortune Smiles: Stories	Adam Johnson
Fragments	Heraclitus
Frankenstein	Mary Shelley
Freedom: A Novel	Jonathan Franzen
Friday	Michel Tournier
Fried Green Tomatoes	Fannie Flagg
From Here to Eternity	James Jones
Froth on the daydream	Boris Vian
Fugitive Pieces	Anne Michaels
Furor and Mystery	René Char
G.	John Berger
Gabriela, Clove and Cinnamon	Jorge Amado
Gargantua and Pantagruel	Francois Rabelais
Gaston	André Franquin
Gateway	Frederik Pohl
Geek Love: A Novel	Katherine Dunn
Genoa: a telling of wonders	Paul C. Metcalf
Gentlemen Prefer Blondes: The Illuminating Diary of a Professional Lady	Anita Loos
Germany, a Winter Tale	Heinrich Heine
Ghachar Ghochar	Vivek Shanbhag
Ghost	Jason Reynolds
Ghostwritten	David Mitchell
Giants in the Earth	Ole Edvart Rolvaag
Gimmick!	Joost Zwagerman
Gimpel the Fool	Isaac B Singer
Girl in Hyacinth Blue	Susan Vreeland
Go Down, Moses	William Faulkner
God's Bits of Wood	Ousmane Sembène
Gogol's Wife	Tommaso Landolfi
Going After Cacciato	Tim O'Brien
Going Native	Stephen Wright
Golden Child	Claire Adam
Gone Girl	Gillian Flynn
Gone With the Wind	Margaret Mitchell
Good Omens	Terry Pratchett, Neil Gaiman
Goodnight Mister Tom	Michelle Magorian
Goodnight Moon	Margaret Wise Brown
Gospels	Various Authors
Green Eggs and Ham	Dr. Seuss
Green Henry	Gottfried Keller
Greenmantle	John Buchan
Guard of Honor	James Gould Cozzens
Guerrillas	V. S. Naipaul
Gulliver's Travels	Jonathan Swift
Guzmán de Alfarache	Mateo Alemán
Habibi	Craig Thompson
Hadrian the Seventh	Frederick Rolfe
Hagoromo: A Celestial Robe	Japan
Half of Man is Woman	Zhang Xianliang
Halftime	Martin Walser
Hallucinating Foucault	Patricia Duncker
Hangover Square: A Story of Darkest Earl's Court	Patrick Hamilton
Hard Times	Charles Dickens
Harry Potter And The Prisoner Of Azkaban	J. K Rowling
Hatchet	Gary Paulsen
Haunted	Chuck Palahniuk
Hawaii	James Albert Michener
Hawksmoor	Peter Ackroyd
Heat and Dust	Ruth Prawer Jhabvala
Heavy Wings	Zhang Jie
Heinrich of Ofterdingen	Novalis
Her Body and Other Parties: Stories	Carmen Maria Machado
Her Privates We	Frederic Manning
Here's to You, Jesusa!	Elena Poniatowska
Herland	Charlotte Perkins Gilman
High Fidelity	Nick Hornby
His Family	Ernest Poole
Histoire de Babar	Jean de Brunhoff
History	Elsa Morante
Hogg	Samuel Delany
Holes	Louis Sachar
Holiday	Stanley Middleton
Home and the World	Rabindranath Tagore
Home Fire	Kamila Shamsie
Home Land	Sam Lipsyte
Home to Harlem	Claude McKay
Homegoing	Yaa Gyasi
Honey in the Horn	Harold L. Davis
Hopeful Monsters	Nicholas Mosley
Hopscotch	Julio Cortázar
Horseman, Pass By: A Novel	Larry McMurtry
Hotel du Lac	Anita Brookner
House Made of Dawn	N. Scott Momaday
House Mother Normal	B. S. Johnson
House of Leaves	Mark Z. Danielewski
House with the Blind Glass Windows	Herbjørg Wassmo
Household Tales	Brothers Grimm
Housekeeping	Marilynne Robinson
How Far Can You Go?	David Lodge
How German Is It	Walter Abish
How Green Was My Valley	Richard Llewellyn
How I Live Now	Meg Rosoff
How Should a Person Be?	Sheila Heti
How the Garcia Girls Lost Their Accents	Julia Alvarez
I Am Legend	Richard Matheson
I Capture the Castle	Dodie Smith
I Loved You More	Tom Spanbauer
I Malavoglia	Giovanni Verga
I Thought of Daisy	Edmund Wilson
I Wish Someone Were Waiting for Me Somewhere	Anna Gavalda
I, Alex Cross	James Patterson
I, Claudius	Robert Graves
I, etcetera	Susan Sontag
I, Robot	Isaac Asimov
I, Tituba, Black Witch of Salem	Maryse Condé
Ice-Candy-Man	Bapsi Sidhwa
If He Hollers Let Him Go	Chester Himes
If Nobody Speaks of Remarkable Things	Jon McGregor
If: A Father's Advice to His Son	Rudyard Kipling
Il Piacere	Gabriele D'Annunzio
I'm Not Scared	Niccolò Ammaniti
Impressions of Africa	Raymond Roussel
In Memoriam to Identity	Kathy Acker
In Parenthesis	David Jones
In Search of Klingsor	Jorge Volpi Escalante
In Search of Lost Time	Marcel Proust
In This Our Life	Ellen Glasgow
Independent People	Halldor Laxness
Indian Summer of a Forsyte	John Galsworthy
Indigo	Marina Warner
Inland	Gerald Murnane
Interpreter of Maladies	Jhumpa Lahiri
Interview with the Vampire	Anne Rice
Invisible Man	Ralph Ellison
It: A Novel	Stephen King
Italian Folktales	Italo Calvino
Jacob the Liar	Jurek Becker
Jakob Von Gunten	Robert Walser
James and the Giant Peach	Roald Dahl
Jayber Crow	Wendell Berry
John Wesley's Sermons: An Anthology	Albert C. Outler
Jonathan Livingston Seagull	Richard Bach
Jonathan Strange and Mr Norrell	Susanna Clarke
Journey	Moonlight
Journey in the Dark	Martin Flavin
Journey to the West	Wu Cheng'en
Joy in the Morning	P. G. Wodehouse
Juan De Mairena	Antonio Machado
Julian	Gore Vidal
Julie, or the New Heloise	Jean-Jacques Rousseau
Jurassic Park	Michael Crichton
Justine	Lawrence Durrell
Kaaterskill Falls	Allegra Goodman
Kabbalah	Unknown
Kallocain	Karin Boye
Kane and Abel	Jeffrey Archer
Kaputt	Curzio Malaparte
Kaspar and Other Plays	Peter Handke
Kate Vaiden	Reynolds Price
Kieron Smith, Boy	James Kelman
Killshot	Elmore Leonard
Kiss of the Spider Woman	Manuel Puig
Kitchen	Banana Yoshimoto
Kolyma Tales	Varlan Shalanov
Krik? Krak!	Edwidge Danticat
Kristin Lavransdatter	Sigrid Undset
Kruger's Alp	Christopher Hope
L.A. Confidential	James Ellroy
La Nuit obscure	Jean de la Croix
La Regenta	Clarín
La Saga/ Fuga de J. B./ The Saga/ Escape of J.B.	Gonzalo Torrente Ballester
L'Abbé C	Georges Bataille
Lad: a Dog	Albert Payson Terhune
Lady into Fox	David Garnett
Lady Number Thirteen	José Carlos Somoza
Lamb in His Bosom	Caroline Miller
Landing Light	Don Paterson
LaRose	Louise Erdrich
Larva: Midsummer Night's Babel	Julián Ríos
Last Evenings with Teresa	Juan Marse
Last Exit to Brooklyn	Hubert Selby
Laughing Boy	Oliver La Farge
Le Bateau Ivre	Arthur Rimbaud
Le Cid	Pierre Corneille
Le Diable au corps	Raymond Radiguet
Le Morte d'Arthur	Thomas Malory
Le Roman de la Rose	Guillaume (de Lorris)
Leading the Cheers	Justin Cartwright
Leaving the Atocha Station	Ben Lerner
Left Behind	Tim LaHaye, Jerry B. Jenkins
Legend	David Gemmell
Legends of The Fall	Jim Harrison
Lenz	Georg Buchner
Les Contemplations	Victor Hugo
Les Destinées	Alfred de Vigny
Les Enfants Terribles	Jean Cocteau
Les Filles du feu	Gerard de Nerval
Les Tragiques	Agrippa d'Aubigné
Less	Andrew Sean Greer
Less Than Angels	Barbara Pym
Let the Great World Spin: A Novel	Colum McCann
Levels of Life	Julian Barnes
Libra	Don DeLillo
Life and Death of Harriett Frean	May Sinclair
Life and Fate	Vasily Grossman
Life in the Far West	George Frederick Ruxton
Life Is a Dream	Pedro Calderón de la Barca
Life of Christ	Giovanni Papini
Life of Pi	Yann Martel
Light	M. John Harrison
Like Water For Chocolate	Laura Esquivel
Little Fires Everywhere	Celeste Ng
Little House on the Prairie	Laura Ingalls Wilder
Little Women	Louisa May Alcott
Little, Big	John Crowley
Lives Other Than My Own	Emmanuel Carrère
Living Up The Street	Gary Soto
Lolly Willowes	Sylvia Townsend Warner
Looking for Alaska	John Green
Lookout cartridge	Joseph McElroy
Lord of Misrule: The Morganville Vampires	Rachel Caine
Los lanzallamas	Roberto Arlt
Lost Horizon	James Hilton
Love in Excess; or, The Fatal Enquiry	Eliza Haywood
Lucy	Jamaica Kincaid
Luka	Antun Šoljan
Lyrical Ballads	William Wordsworth, Samuel Taylor Coleridge
Maggie: A Girl of the Streets	Stephen Crane
Maldoror (Les Chants de Maldoror)	Comte de Lautréamont
Man in the Holocene	Max Frisch
Manhattan Transfer	John Dos Passos
Manon des sources	Marcel Pagnol
Manon Lescaut	Abbe Prevost
Man's Fate	Andre Malraux
Mansfield Park	Jane Austen
March	Geraldine Brooks
Margot and the Angels	Kristien Hemmerechts
Marius the Epicurean	Walter Pater
Marivaux: Three Plays	Pierre Carlet de Chamblain de Marivaux
Martín Fierro	José Hernández
Masnavi	Jalal al-Din Muhammad Rumi
Mason & Dixon	Thomas Pynchon
Master and Commander	Patrick O'Brian
Masterworks of the Classical Haida Mythtellers	Robert Bringhurst
Matterhorn	Karl Marlantes
Max Havelaar	Multatuli
Measuring the World	Daniel Kehlmann
Melmoth the Wanderer	Charles Robert Maturin
Memed, My Hawk	Yashar Kemal
Memoirs of a Geisha	Arthur Golden
Memoirs of a Peasant Boy	Xosé Neira Vilas
Memoirs of Martinus Scriblerus	Scriblerus Club
Memories of Rain	Sunetra Gupta
Men Without Women	Ernest Hemingway
Mensagem	Fernando Pessoa
Metamorphoses	Ovid
Middle Passage	Charles R. Johnson
Milkman	Anna Burns
Mio, My Son	Astrid Lindgren
Mislaid	Nell Zink
Miss Julie	August Strindberg
Miss Pettigrew Lives for a Day	Winifred Watson
Miss Pickerell Goes to Mars	Ellen Macgregor
Miss Susie Slagle's	Augusta Tucker
Moll Flanders	Daniel Defoe
Monica	Saunders Lewis
Monsignor Quixote	Graham Greene
Moon Tiger	Penelope Lively
Moravagine	Blaise Cendrars
More Than Human	Theodore Sturgeon
Mortal y rosa	Francisco Umbral
Mortals	Norman Rush
Morte D'Urban	J. F. Powers
Morvern Callar	Alan Warner
Moscow-Petushki	Venedikt Yerofeev
Mother	Maksim Gorky
Motherless Brooklyn	Jonathan Lethem
Mr. American	George MacDonald Fraser
Mr. Sammler's Planet	Saul Bellow
Mrs. Bridge	Evan S. Connell
Mulligan Stew	Gilbert Sorrentino
Music and Silence	Rose Tremain
My Book House	Olive Beaupré Miller
My City: A Hong Kong Story	Xi Xi
My Life and My Life in the Nineties	Lyn Hejinian
My Name Is Aram	William Saroyan
My Year of Rest and Relaxation	Ottessa Moshfegh
Mysteries	Knut Hamsun
Mystic River	Dennis Lehane
Mythologies	Roland Barthes
Nada	Carmen Laforet
Nathan the Wise	Gotthold Ephraim Lessing
Native American Folktales	Thomas A. Green
Nausea	Jean Paul Sartre
Nectar in a Sieve	Kamala Markandaya
Nero Wolfe	Rex Stout
Nervous Conditions	Tsitsi Dangarembga
Netherland	Joseph O'Neill
Never Mind	Edward St Aubyn
New Atlantis	Francis Bacon
New Grub Street: A Novel	George Gissing
News from Nowhere	William Morris
Night Watch	Terry Pratchett
Nightmare Abbey	Thomas Love Peacock
Nightwood	Djuna Barnes
Njal's Saga	Iceland
No Laughing Matter	Angus Wilson
No Orchids for Miss Blandish	James Hadley Chase
Nog	Rudy Wurlitzer
None but the Brave	Arthur Schnitzler
Normal People	Sally Rooney
North and South	Elizabeth Gaskell
Notes from No Man's Land: American Essays	Eula Biss
Notes on a Scandal	Zoë Heller
Nothing Like the Sun	Anthony Burgess
Noughts and Crosses	Malorie Blackman
Novel on Yellow Paper	Stevie Smith
Now in November	Josephine Winslow Johnson
Obabakoak	Bernardo Atxaga
Obasan	Joy Kogawa
Oblivion: Stories	David Foster Wallace
Oblomov	Ivan Goncharov
October Light	John Gardner
Odes	John Keats
Of Time and the River: A Legend of Man's Hunger in His Youth	Thomas Wolfe
Omensetter's Luck	William H. Gass
On Love	Alain de Botton
On the Black Hill	Bruce Chatwin
On the Bus with Rosa Parks	Rita Dove
On the Heights of Despair	Emil Cioran
One Hundred and One Poems	Paul Verlaine
One of Ours	Willa Cather
One Thousand and One Nights	India/Iran/Iraq/Egypt
One, No One and One Hundred Thousand	Luigi Pirandello
Ooga-Booga	Frederick Seidel
Oroonoko	Aphra Behn
Our Lady of the Assassins	Fernando Vallejo
Our Lady of the Flowers	Jean Genet
Out Stealing Horses	Per Petterson
Outlander	Diana Gabaldon
Outline	Rachel Cusk
Outside Over There	Maurice Sendak
Paco's Story	Larry Heinemann
Palace of the Peacock	Wilson Harris
Palace Walk	Naguib Mahfouz
Pallieter	Felix Timmermans
Pamela	Samuel Richardson
Parade's End	Ford Madox Ford
Paris Trout	Pete Dexter
Party Going	Henry Green
Parzival	Wolfram Eschenbach
Passing	Nella Larsen
Patterns of Childhood	Christa Wolf
Penguin Island	Anatole France
Pepita Jimenez	Juan Valera y Alcalá-Galiano
Percy Jackson and the Olympians, Book One: Lightning Thief, The	Rick Riordan
Pereira Maintains	Antonio Tabucchi
Persepolis Two	Marjane Satrapi
Petals of blood	Ngugi wa Thiong'o
Peter Pan	J. M. Barrie
Petersburg	Andrei Bely
Petrarch's Songbook	Francesco Petrarca
Peyton Place	Grace Metalious
Phaedrus	Plato
Philoctetes	Sophocles
Picture Palace	Paul Theroux
Pilgrimage	Dorothy Richardson
Pilgrim's Progress	John Bunyan
Plains Song	Wright Morris
Plainsong	Kent Haruf
Platero	Juan Ramón Jiménez
Poems	Machado
Poems	Paul Celan
Poems	Miguel de Unamuno
Poems of Alfred Lord Tennyson	Alfred Lord Tennyson
Poems of Emily Dickinson	Emily Dickinson
Poems of Eugenio Montale	Eugenio Montale
Poems of Federico García Lorca	Federico García Lorca
Poems of Friedrich Hölderlin	Friedrich Holderlin
Poems of Góngora	Luis de Góngora
Poems: Selected and New, 1950-1974	Adrienne Rich
Poetry	Quintus Lutatius Catulus
Point Counter Point	Aldous Huxley
Poor Cow	Nell Dunn
Poor Things	Alasdair Gray
Possessing the Secret of Joy	Alice Walker
Postcards	E. Annie Proulx
Practical Magic	Alice Hoffman
Preparation for the Next Life	Atticus Lish
Presumed Innocent	Scott Turow
Prufrock and Other Observations	T. S. Eliot
Pure	Andrew Miller
Purple Hibiscus	Chimamanda Ngozi Adichie
Pushcart Prize Anthology	Pushcart Prize
Pygmalion	Bernard Shaw
Quarantine	Jim Crace
Quo Vadis	Henryk Sienkiewicz
Raise High the Roof Beam, Carpenters: And, Seymour, an Introduction	J. D. Salinger
Rapture	Carol Ann Duffy
Rashomon and Seventeen Other Stories	Ryunosuke Akutagawa
Ready Player One	Ernest Cline
Rebecca	Daphne du Maurier
Red at the Bone	Jacqueline Woodson
Red Clocks	Leni Zumas
Red Dragon	Thomas Harris
Redeployment	Phil Klay
Remainder	Tom McCarthy
Remembering Babylon	David Malouf
Renascence and Other Poems	Edna St. Vincent Millay
Requiem	Anna Akhmatova
Residence on Earth	Pablo Neruda
Restless	William Boyd
Resurrection: A Novel	Leo Tolstoy
Retold African American Folktales	David Haynes
Retreat Without Song	Shahan Shahnour
Return to Oegstgeest	Jan Wolkers
Revolutionary Road	Richard Yates
Rhythms	Harry Martinson
Riddle of the Sands	Erskine Childers
Riddley Walker	Russell Hoban
Riders	Jilly Cooper
Riders of the Purple Sage	Zane Grey
Rimas	Gustavo Adolfo Bécquer
Rites of Passage	William Golding
Rituals	Cees Nooteboom
River of Fire	Qurratulain Hyder
Rivers and Mountains	John Ashbery
Rob Roy	Walter Scott
Robert Browning's Poetry	Robert Browning
Roll of Thunder, Hear My Cry	Mildred D. Taylor
Romance of the Three Kingdoms	Guanzhong Luo
Roots	Alex Haley
Rubaiyat of Omar Khayyam	Edward FitzGerald
Rubyfruit Jungle	Rita Mae Brown
Runaway	Alice Munro
Sacred Hunger	Barry Unsworth
Samuel Pepys: The Unequalled Self	Claire Tomalin
Samuels bok	Sven Delblanc
Sandokan	Emilio Salgari
Santa Evita	Tomás Eloy Martínez
Sarah, Plain and Tall	Patricia MacLachlan
Saturday	Ian McEwan
Savages: A Novel	Don Winslow
Saville	David Storey
Say You’re One of Them	Uwem Akpan
Scarlet Sister Mary	Julia Peterkin
Schatzkästlein des Rheinischen Hausfreundes	Johann Peter Hebel
Schindler's List	Thomas Keneally
Sea of Poppies	Amitav Ghosh
Searching for Caleb	Anne Tyler
Season of Migration to the North	Al-Tayyib Salih
Seaview	Toby Olson
Second Thoughts	Michel Butor
Second-class Citizen	Buchi Emecheta
Selected Poems	Pierre Ronsard
Selected Poems	Andrew Marvell
Selected Poems of Gabriela Mistral	Gabriela Mistral
Selected Poems of Lord Byron	Lord Byron
Selected Stories	D. H. Lawrence
Selected Stories of Lu Hsun	Xun Lu
Selected Stories of Philip K. Dick	Philip K. Dick
Senilità	Italo Svevo
Sent for You Yesterday	John Edgar Wideman
Seven Against Thebes	Aeschylus
Seven Gothic Tales	Karen Blixen
Seven Years	Peter Stamm
Sexual Perversity in Chicago	David Mamet
Shadow Country	Peter Matthiessen
Shadows on the Hudson: A Novel	Isaac Bashevis Singer
Shahnameh	Ferdowsi
She	H. Rider Haggard
Ship Fever and Other Stories	Andrea Barrett
Shogun	James Clavell
Siebenkäs	Jean Paul
Signs Preceding the End of the World	Yuri Herrera
Silence	Shusaku Endo
Silence de la Mer	Vercors
Silk	Alessandro Baricco
Silver City	Maurice Leitch
Simon and the Oaks	Marianne Fredriksson
Simplicius Simplicissimus	Hans Jakob Christoffel von Grimmelshausen
Sing, Unburied, Sing	Jesmyn Ward
Sir Gawain and the Green Knight	Simon Armitage
Sister Carrie	Theodore Dreiser
Sixty Stories	Donald Barthelme
Skinny Legs and All	Tom Robbins
Sleeping Beauty	Ross Macdonald
Sleeping It Off in Rapid City	August Kleinzahler
Small Island	Andrea Levy
Smell of Sadness	Alfred Kossmann
Smilla's Sense of Snow: A Novel	Peter Høeg
Smoky the Cowhorse	Will James
Snow Country	Yasunari Kawabata
Snow Crash	Neal Stephenson
Snow Falling on Cedars	David Guterson
Snow Flower and the Secret Fan	Lisa See
So Big	Edna Ferber
So Long a Letter	Mariama Bâ
So Long, See You Tomorrow	William Maxwell
Sold	Patricia McCormick
Soldiers in Hiding	Richard Wiley
Soldiers of Salamis	Javier Cercas
Solitude	Caterina Albert
Some Experiences of an Irish R. M.	Edith Somerville, Violet Florence Martin
Something to Answer For	P. H. Newby
Sometimes a Great Notion	Ken Kesey
Song of Songs	Christian Church
Sóngoro cosongo	Nicolás Guillén
Songs of Innocence and Experience	William Blake
Sonnets	Julián Olivares
Sonnets from the Portuguese	Elizabeth Barrett Browning
Sophie's World: A Novel About the History of Philosophy	Jostein Gaarder
Soul Mountain	Xingjian Gao
Southern Seas	Manuel Vázquez Montalbán
Spain, Take This Chalice from Me	César Vallejo
Spartina	John Casey
Speak	Laurie Halse Anderson
Speedboat	Renata Adler
Spies	Michael Frayn
Splendors and Miseries of Courtesans	Honore De Balzac
Spoon River Anthology	Edgar Lee Masters
Spreadeagle	Kevin Killian
Station Eleven	Emily St John Mandel
Staying Alive	Neil Astley
Staying On	Paul Scott
Stockholm series	Per Anders Fogelström
Stone Junction: An Alchemical Pot-Boiler	Jim Dodge
Stoner	John Williams
Stories	T. C. Boyle
Stories	Heinrich von Kleist
Stories from the Lord Keuner	Dieter Wöhrle
Stories of Adalbert Stifter	Adalbert Stifter
Stories of Nikolai Gogol	Nikolai Gogol
Stories of Washington Irving	Washington Irving
Stories of Your Life and Others	Ted Chiang
Stormbreaker	Anthony Horowitz
Story of Ferdinand	Munro Leaf
Story of O	Pauline Reage
Strait is the Gate	André Gide
Strange Fruit	Lillian Smith
Stranger Things Happen	Kelly Link
Strumpet City	James Plunkett
Struwwelpeter, Or, Merry Rhymes and Funny Pictures...	Heinrich Hoffmann
Studs Lonigan	James T. Farrell
Success: Three Years in the Life of a Province	Lion Feuchtwanger
Sudden Death	Alvaro Enrigue
Sudelbücher	Georg Christoph Lichtenberg
Suite Française	Irène Némirovsky
Summer in Baden-Baden	Leonid Tsypkin
Super Sad True Love Story	Gary Shteyngart
Swallows and Amazons	Arthur Ransome
Swamplandia!	Karen Russell
Swan Song	Robert R. McCammon
Sweet Days of Discipline	Fleur Jaeggy
Swing Hammer Swing!	Jeff Torrington
Swing Time	Zadie Smith
Sybil: Or The Two Nations	Benjamin Disraeli
Taebaek Sanmaek	Jo Jung-rae
Taipei	Tao Lin
Tales from the Kathasaritsagara	Somadeva
Tales of H. P. Lovecraft	H. P. Lovecraft
Tales of the City	Armistead Maupin
Talk Before Sleep	Elizabeth Berg
Tarka the Otter	Henry Williamson
Teahouse	Lao She
Tell Me a Riddle	Tillie Olsen
Ten North Frederick	John O'Hara
Tender Buttons	Gertrude Stein
Thank You and Other Poems	Kenneth Koch
That They May Face the Rising Sun	John McGahern
The 120 Days of Sodom	Marquis de Sade
The 13 Clocks	James Thurber
The Able McLaughlins	Margaret Wilson
The Abyss	Marguerite Yourcenar
The Accidental	Ali Smith
The Adventures and Misadventures of Maqroll	Alvaro Mutis
The Adventures of Caleb Williams	William Godwin
The Adventures of Peregrine Pickle	Tobias Smollett
The Aeneid	Virgil
The African Child	Camara Laye
The Age of Anxiety	W. H. Auden
The Age of Wire and String	Ben Marcus
The Alberta Trilogy	Cora Sandel
The Alienist	Caleb Carr
The Animals' Conference	Erich Kästner
The Apes of God	Wyndham Lewis
The Arrival	Shaun Tan
The Art of Fielding	Chad Harbach
The Awakening	Kate Chopin
The Back Room	Carmen Martín Gaite
The Bald Soprano	Eugène Ionesco
The Ballad of Peckham Rye	Muriel Spark
The Ballad of the Sad Cafe	Carson McCullers
The Barracks Thief	Tobias Wolff
The Bastard of Istanbul	Elif Shafak
The Bear Comes Home	Rafi Zabor
The Beautiful Mrs. Seidenman	Andrzej Szczypiorski
The Beauty Of The Husband	Anne Carson
The Beautyful Ones are Not Yet Born	Ayi K. Armah
The Beginning of Spring	Penelope Fitzgerald
The Bell Jar	Sylvia Plath
The Betrothed	Alessandro Manzoni
The Bird of Night	Susan Hill
The Birds	Tarjei Vesaas
The Bitter Glass	Eilís Dillon
The Black Book	Orhan Pamuk
The Black Swan	Thomas Mann
The Blazing World	Siri Hustvedt
The Blind Side of the Heart	Julia Franck
The Blithedale Romance	Nathaniel Hawthorne
The Blue Lotus	Hergé
The Blue Sword	Robin McKinley
The Bluest Eye	Toni Morrison
The Bone People	Keri Hulme
The Bonesetter's Daughter	Amy Tan
The Book of Salt	Monique Truong
The Book of Strange New Things	Michel Faber
The Book of the City of Ladies	Christine De Pizan
The Book Thief	Markus Zusak
The Book-Dealer Who Ceased Bathing	Fritiof Nilsson Piraten
The Box Man	Kobo Abé
The Boy in the Striped Pyjamas	John Boyne
The Bridge	Hart Crane
The Bronc People	William Eastlake
The Buddha in the Attic	Julie Otsuka
The Buddha of Suburbia	Hanif Kureishi
The Burden of Our Time	Hannah Arendt
The Burn: A Novel in Three Books : (late Sixties--early Seventies)	Vassily Aksyonov
The Burning Plain and Other Stories	Juan Rulfo
The Butcher Boy	Patrick McCabe
The Caine Mutiny	Herman Wouk
The Canterbury Tales	Geoffrey Chaucer
The Caprices	Sabina Murray
The Carhullan Army	Sarah Hall
The Case of Comrade Tulayev	Victor Serge
The Case of Sergeant Grischa	Arnold Zweig
The Case Worker	György Konrád
The Castle of Otranto: A Gothic Story	Horace Walpole
The Cathedral	Oles Honchar
The Chaneysville Incident	David Bradley
The Changeling	Joy Williams
The Charterhouse of Parma	Stendhal
The Charwoman's Daughter	James Stephens
The Children of Men	P. D. James
The Children's Book	A. S. Byatt
The Chip Chip Gatherers	Shiva Naipaul
The Christmas Oratorio	Göran Tunström
The Chronicles of Barsetshire	Anthony Trollope
The Chymical Wedding	Lindsay Clarke
The Cider House Rules	John Irving
The Clan of the Cave Bear	Jean M. Auel
The Clay Machine-gun	Viktor Pelevin
The Cloister and the Hearth	Charles Reade
The Clouds	Aristophanes
The Clown	Heinrich Böll
The Club Dumas	Arturo Pérez-Reverte
The Coldest Winter Ever	Sister Souljah
The Collected Poems of A. E. Housman	A. E. Housman
The Collected Poems of Audre Lorde	Audre Lorde
The Collected Poems of Langston Hughes	Langston Hughes
The Collected Poems of Theodore Roethke	Theodore Roethke
The Collected Poems of William Carlos Williams: 1909-1939	William Carlos Williams
The Collected Short Stories of Maxim Gorky	Maxim Gorky
The Collected Songs of Cold Mountain	Han Shan
The Collected Stories	Grace Paley
The Collected Stories of Amy Hempel	Amy Hempel
The Collected Stories of Deborah Eisenberg: Stories	Deborah Eisenberg
The Collected Stories of Isaac Babel	Isaac Babel
The Collected Stories of Jean Stafford	Jean Stafford
The Collected Works	Kahlil Gibran
The Collected Works of Paul Valéry	Paul Valéry
The Collected Works of St. John of the Cross	St. John of the Cross
The Comforts of Madness	Paul Sayer
The Commandant	Jessica Anderson
The Commitments	Roddy Doyle
The Complete Fairy Tales of Charles Perrault	Charles Perrault
The Complete Poems	Philip Larkin
The Complete Poems of Marianne Moore	Marianne Moore
The Complete Poems of Samuel Taylor Coleridge	Samuel Coleridge
The Complete Poetry and Essential Prose of John Milton	John Milton
The Complete Poetry and Selected Prose of John Donne	John Donne
The Complete Short Stories of Jack London	Jack London
The Complete Stories	Zora Neale Hurston
The Complete Works of Nathanael West	Nathanael West
The Complete Writings of Alfred de Musset	Alfred de Musset
The Confessions of Nat Turner	William Styron
The Confusions of Young Törless	Robert Musil
The Conservationist	Nadine Gordimer
The Continental Op	Dashiell Hammett
The Country of the Pointed Firs	Sarah Orne Jewett
The Coup	John Updike
The Crow Road	Iain Banks
The Cunning Man	Robertson Davies
The Curious Incident of the Dog in the Night-time	Mark Haddon
The Custom of the Country	Edith Wharton
The Czar's Madman	Jaan Kross
The Da Vinci Code	Dan Brown
The Damned Utd	David Peace
The Daughter	Pavlos Matesis
The Daughter of Time	Josephine Tey
The Day of the Dolphin	Robert Merle
The Day of the Jackal	Frederick Forsyth
The Days of His Grace	Eyvind Johnson
The deadbeats: a novel	Ward Ruyslinck
The Deceivers	John Masters
The Destiny Waltz	Gerda Charles
The Destroyers	Christopher Bollen
The Devil and Miss Prym	Paulo Coelho
The Devil to Pay in the Backlands	Joao Guimaraes Rosa
The Devil's Pool	George Sand
The Dharma Bums	Jack Kerouac
The Diary of a Country Priest	Georges Bernanos
The Diary of a Nobody	George Grossmith, Weedon Grossmith
The Diary of Anais Nin, 1931-1934	Anaïs Nin
The Discovery of Heaven	Harry Mulisch
The Divine Comedy	Dante Alighieri
The Diviners	Margaret Laurence
The Dog Star	Agneta Pleijel
The Dogs of March	Ernest Hebert
The Dwarf	Par Lagerkvist
The Dying Earth	Jack Vance
The Dyskolos	Menander
The Edge of Sadness	Edwin O'Connor
The Education of Little Tree	Forrest Carter
The Eighth Day	Thornton Wilder
The Elected Member	Bernice Rubens
The Elegance of the Hedgehog	Muriel Barbery
The Emigrants	Winfried Georg Sebald
The Emigrants	Vilhelm Moberg
The Emperor's Babe	Bernardine Evaristo
The Emperor's Children	Claire Messud
The Enchanted Wanderer	Nikolai Leskov
The Enchanted Wood	Enid Blyton
The Enchantress of Florence	Salman Rushdie
The End of the Story	Lydia Davis
The Engineer of Human Souls	Josef Škvorecký
The Enormous Room	E. E. Cummings
The Epicure's Lament	Kate Christensen
The Essential Dykes to Watch Out For	Alison Bechdel
The Eye in the Door	Pat Barker
The Faerie Queene	Edmund Spenser
The Far Pavilions	M. M. Kaye
The Female Quixote	Charlotte Lennox
The Fifth Season	N. K. Jemisin
The Figaro Trilogy: The Barber of Seville, The Marriage of Figaro, The Guilty Mother	Pierre-Augustin Caron de Beaumarchais
The Finkler Question: A Novel	Howard Jacobson
The First Garden	Anne Hébert
The First Man	Albert Camus
The Flamethrowers: A Novel	Rachel Kushner
The Flowers of Evil	Charles Baudelaire
The Forbidden Kingdom	Jan Jacob Slauerhoff
The Fortunes Of Richard Mahony	Henry Handel Richardson
The Fountainhead	Ayn Rand
The Franchiser	Stanley Elkin
The Gambler	Fyodor Dostoyevsky
The Garden of the Finzi-Continis	Giorgio Bassani
The Garden Where the Brass Band Played	Simon Vestdijk
The Garlic Ballads: A Novel	Yan Mo
The General of the Dead Army	Ismail Kadare
The German Lesson	Siegfried Lenz
The Ghost	Robert Harris
The Ginger Man	J. P. Donleavy
The Girl with the Dragon Tattoo	Stieg Larsson
The Giver	Lois Lowry
The Glass Bees	Ernst Jünger
The God of Small Things	Arundhati Roy
The Godfather	Mario Puzo
The Golden Apples	Eudora Welty
The Golden Ass (Metamorphoses): Or Metamorphoses	Apuleius
The Golden Compass	Philip Pullman
The Golden Gate	Vikram Seth
The Goldfinch	Donna Tartt
The Good Earth	Pearl S. Buck
The Good Lord Bird: A Novel	James McBride
The Good Soldier Svejk	Jaroslav Hašek
The Graduate	Charles Webb
The Great Fire	Shirley Hazzard
The Great Indian Novel	Shashi Tharoor
The Green Hat	Michael Arlen
The Green Road	Anne Enright
The Gruffalo	Julia Donaldson
The Guiltless	Hermann Broch
The Hair of Harold Roux	Thomas Williams
The Half Brother: A Novel	Lars Saabye Christensen
The Hand That First Held Mine	Maggie O'Farrell
The Hardy Boys	Franklin W. Dixon
The Harvesters	Cesare Pavese
The Hate U Give	Angie Thomas
The Haunting of Hill House	Shirley Jackson
The Hearts and Lives of Men: A Novel	Fay Weldon
The Heather Blazing	Colm Toibin
The Help	Kathryn Stockett
The Heretic	Miguel Delibes
The History of Love	Nicole Krauss
The History of Mr. Polly	H. G. Wells
The History of Rasselas, Prince of Abissinia	Samuel Johnson, Abraham Raimbach, Robert Smirke
The Hive	Camilo José Cela
The Hobbit	J. R. R. Tolkien
The Horse Whisperer	Nicholas Evans
The Horseman on the Roof	Jean Giono
The Horse's Mouth	Joyce Cary
The House at Pooh Corner	A. A Milne
The House Of Splendid Isolation	Edna O'Brien
The House of Ulloa	Emilia Pardo Bazán
The House on Mango Street	Sandra Cisneros
The Hunger Games	Suzanne Collins
The Hunt for Red October	Tom Clancy
The Hunting Gun	Yasushi Inoue
The Hunting of the Snark: An Agony, in Eight Fits	Lewis Carroll
The Ice Storm: A Novel	Rick Moody
The Iceman Cometh	Eugene O'Neill
The Iliad	Homer
The Illustrious House of Ramires	Eça de Queirós
The Importance of Being Earnest	Oscar Wilde
The Incendiaries	R. O. Kwon
The Indian Lawyer	James Welch
The Infatuations	Javier Marías
The Inheritance of Loss	Kiran Desai
The Interior Castle	Teresa of Avila
The Interrogation	J. M. G. Le Clezio
The Invented Part	Rodrigo Fresán
The Invention of Curried Sausage	Uwe Timm
The Island Within	Ludwig Lewisohn
The Jade Cabinet	Rikki Ducornet
The Joke	Milan Kundera
The Kalevala	Elias Lönnrot
The Keepers of the House	Shirley Ann Grau
The Killer Angels	Michael Shaara
The Killer Inside Me	Jim Thompson
The Kindly One	Jonathan Littell
The King Must Die	Mary Renault
The Kingdom of This World	Alejo Carpentier
The Known World	Edward P. Jones
The Labyrinth of Solitude	Octavio Paz
The Lady with the Dog	Anton Chekhov
The Largesse of the Sea Maiden: Stories	Denis Johnson
The Last Days of Mankind	Karl Kraus
The Last Gentleman	Walker Percy
The Last Good Kiss	James Crumley
The Last Samurai	Helen DeWitt
The Last Temptation of Christ	Nikos Kazantzakis
The Last World	Christoph Ransmayr
The Late George Apley	John P. Marquand
The Late-night News	Petros Markaris
The Laws	Connie Palmen
The Lazarus Project	Aleksandar Hemon
The Leavers	Lisa Ko
The Leopard	Giuseppe Tomasi di Lampedusa
The Lesser Bohemians	Eimear McBride
The Life and Opinions of the Tomcat Murr	E. T. A. Hoffmann
The Life of Insects	Victor Pelevin
The Lime Twig	John Hawkes
The Lion and the Mouse	Jerry Pinkney
The Lion of Flanders	Hendrik Conscience
The Little Engine that Could	Platt & Munk
The Little Grey Men	B B
The Little Prince	Antoine de Saint-Exupéry
The Little Stranger	Sarah Waters
The Living and the Dead	Patrick White
The Loneliness of the Long-distance Runner	Alan Sillitoe
The Lonely Londoners	Sam Selvon
The Long Ships	Frans G. Bengtsson
The Loser	Thomas Bernhard
The Lost Language of Cranes	David Leavitt
The Lost Leader	Mick Imlah
The Lovely Bones	Alice Sebold
The Loyal Subject	Heinrich Mann
The Luminaries	Eleanor Catton
The Lusiad	Luís Vaz Camões
The Magic Toyshop	Angela Carter
The Magician's Nephew	C. S. Lewis, Clive Staples Lewis
The Magus	John Fowles
The Makioka Sisters	Junichiro Tanizaki
The Mambo Kings Play Songs of Love	Oscar Hijuelos
The Man of Feeling	Henry Mackenzie
The Man Who Loved Children	Christina Stead
The Man Who Was Thursday	G. K. Chesterton
The Man with the Golden Arm	Nelson Algren
The Man Without a Way	Erik Lindegren
The Mandarins	Simone de Beauvoir
The Manila Rope	Veijo Meri
The Manuscript Found in Saragossa	Jan Potocki
The Marriage Of Cadmus And Harmony	Roberto Calasso
The Martian	Andy Weir
The Martian Chronicles	Ray Bradbury
The Mask of Dimitrios	Eric Ambler
The Master and Margarita	Mikhail Bulgakov
The Master of Ballantrae: A Winter's Tale	Robert Louis Stevenson
The Melancholy of Resistance	László Krasznahorkai
The Memoirs of a Survivor	Doris May Lessing
The Merchant of Venice	William Shakespeare
The Merry Adventures of Robin Hood	Howard Pyle
The Middleman and Other Stories	Bharati Mukherjee
The Midnight Examiner	William Kotzwinkle
The Midwich Cuckoos	John Wyndham
The Mind Invaders	Dave Hunt
The Mists of Avalon	Marion Zimmer Bradley
The Monk	Matthew Lewis
The Monkey Wrench Gang	Edward Abbey
The Moon is a Harsh Mistress	Robert A. Heinlein
The Moonstone	Wilkie Collins
The Mysteries of Udolpho	Ann Radcliffe
The Mysterious Affair at Styles	Agatha Christie
The Narrative of Arthur Gordon Pym	Edgar Allan Poe
The Natural	Bernard Malamud
The Needle's Eye	Fanny Howe
The Negro Caravan: Writings	American Negroes
The News from Paraguay	Lily Tuck
The Nickel Boys	Colson Whitehead
The Night Circus	Erin Morgenstern
The Night Manager	John le Carré
The No. 1 Ladies' Detective Agency	Alexander McCall Smith
The Notebook	Nicholas Sparks
The Notebook: The Proof ; The Third Lie : Three Novels	Agota Kristof
The Notebooks of Malte Laurids Brigge	Rainer Maria Rilke
The Nun	Denis Diderot
The Ocean at the End of the Lane	Neil Gaiman
The Odes	Horace
The Old Devils	Kingsley Amis
The Old Jest	Jennifer Johnston
The Old Wives' Tale	Arnold Bennett
The Once and Future King	T. H. White
The Opposing Shore	Julien Gracq
The Oranging of America	Max Apple
The Orlando Furioso	Lodovico Ariosto
The Outsiders	S. E. Hinton
The Overstory	Richard Powers
The Painted Bird	Jerzy Kosinski
The Palm-Wine Drinkard	Amos Tutola
The Parable of the Blind	Gert Hofmann
The Particular Sadness of Lemon Cake	Aimee Bender
The Passion According to G.H.	Clarice Lispector
The Pearl	John Steinbeck
The Periodic Table	Primo Levi
The Phantom of the Opera	Gaston Leroux
The Phantom Tollbooth	Norton Juster
The Physician	Noah Gordon
The Physicists	Friedrich Dürrenmatt
The Piano Teacher	Elfriede Jelinek
The Pigeon	Patrick Suskind
The Pioneers	James Fenimore Cooper
The Plantagenet Saga	Jean Plaidy
The Poems of Emily Bronte	Emily Brontë
The Poems of Francois Villon	François Villon
The Poems of Percy Bysshe Shelley	Percy Bysshe Shelley
The Poems of Robert Frost	Robert Frost
The Poems of Sappho	Sappho
The Poems of Walt Whitman	Walt Whitman
The Poems of Wilfred Owen	Wilfred Owen
The Poetry of Alexander Pushkin	Alexander Pushkin
The Poetry of Derek Walcott 1948-2013	Derek Walcott
The Poetry of Ezra Pound	Ezra Pound
The Poetry of Luis Cernuda	Luis Cernuda
The Poppy War	R. F. Kuang
The Position	Meg Wolitzer
The Possessed	Elif Batuman
The Postman Always Rings Twice	James M. Cain
The Power of One	Bryce Courtenay
The PowerBook	Jeanette Winterson
The Prelude	William Wordsworth
The Prince and the Pauper: A Tale for Young People of All Ages	Mark Twain
The Prince of Tides	Pat Conroy
The Princess Bride: An Illustrated Edition of S. Morgenstern's Classic Tale of True Love and High Adventure	William Goldman
The Princess of Cleves	Madame de La Fayette
The Private Memoirs and Confessions of a Justified Sinner	James Hogg
The Professional	W. C. Heinz
The Pure and the Impure	Colette
The Pursuit Of Love	Nancy Mitford
The Queen of the Tambourine	Jane Gardam
The Queen's Tiara	Carl Jonas Love Almquist
The Quest	Frederik van Eeden
The Radetzky March	Joseph Roth
The Radiant Way	Margaret Drabble
The Ragged Trousered Philanthropists	Robert Tressell, Peter Miles
The Railway Children	Edith Nesbit
The Rape of the Lock	Alexander Pope
The Razor's Edge	W. Somerset Maugham
The Reader	Bernhard Schlink
The Remorseful Day	Colin Dexter
The Resistible Rise of Arturo Ui	Bertolt Brecht
The Return and Other Stories	Andrey Platonov
The Return of Philip Latinowicz	Miroslav Krleža
The Return of the Soldier	Rebecca West
The Richard Trilogy	Paul Horgan
The Rime of the Ancient Mariner	Samuel Taylor Coleridge
The Rings of Saturn	W. G. Sebald
The Roots of Heaven	Romain Gary
The Rosy Crucifixion	Henry Miller
The Royal Physician's Visit: A Novel	Per Olov Enquist
The Ruins	Scott Smith
The Sacred and Profane Love Machine	Iris Murdoch
The Satin Slipper	Paul Claudel
The Sea	John Banville
The Secret Diary of Adrian Mole Aged 13 3/4	Sue Townsend
The Secret Scripture	Sebastian Barry
The Sellout	Paul Beatty
The Seventh Cross	Anna Seghers
The Shack	William P Young
The Shadow of the Wind	Carlos Ruiz Zafon
The Shawl	Cynthia Ozick
The Shell Seekers	Rosamunde Pilcher
The Sheltering Sky	Paul Bowles
The Shipyard	Juan Carlos Onetti
The Short Stories Of Thomas Hardy	Thomas Hardy
The Siege	Helen Dunmore
The Sign of Four	Arthur Conan Doyle
The Singapore Grip	J. G. Farrell
The Sirens of Titan	Kurt Vonnegut
The Skeleton	Amrita Pritam
The Sluts	Dennis Cooper
The Snowy Day	Ezra Jack Keats
The Soft Machine	William S. Burroughs
The Song of Hiawatha	Henry Wadsworth Longfellow
The Sorrow of Belgium	Hugo Claus
The Sorrow Of War	Bao Ninh
The Soul of Kindness	Elizabeth Taylor
The Spectator Bird	Wallace Stegner
The Spirit Level	Seamus Heaney
The Spoils of Poynton	Henry James
The Sportswriter	Richard Ford
The Statement	Brian Moore
The Stone Raft	José Saramago
The Store	Thomas Sigismund Stribling
The Stories of Vladimir Nabokov	Vladimir Nabokov
The Story Of Edgar Sawtelle	David Wroblewski
The Story of Tracy Beaker	Jacqueline Wilson
The Storyteller	Mario Vargas Llosa
The Strange Case of Peter the Lett	Georges Simenon
The Street of Crocodiles	Bruno Schulz
The Summer Book	Tove Jansson
The Swarm	Frank Schatzing
The Swimming-Pool Library	Alan Hollinghurst
The Sword of the Lictor	Gene Wolfe
The Sympathizer	Viet Thanh Nguyen
The Tale of Genji	Murasaki Shikibu
The Tale of Peter Rabbit	Beatrix Potter
The Talented Mr. Ripley	Patricia Highsmith
The Tartar Steppe	Dino Buzzati
The Tenant of Wildfell Hall	Anne Brontë
The Tenderness of Wolves	Stef Penney
The Terror	Dan Simmons
The Third Policeman	Flann O'Brien
The Thorn Birds	Colleen McCullough
The Three Hundred Tang Poems	China
The Three Musketeers	Alexandre Dumas
The Tiger Who Came to Tea	Judith Kerr
The Time Traveler's Wife	Audrey Niffenegger
The Times Are Never So Bad: A Novella and Eight Short Stories	Andre Dubus
The Tin Flute	Gabrielle Roy
The Tootinameh; Or, Tales of a Parrot	India, Iran
The Tragical History of Doctor Faustus	Christopher Marlowe
The Travels of Jaimie McPheeters	Robert Lewis Taylor
The Travels of Persiles and Sigismunda	Miguel de Cervantes
The Trick Is to Keep Breathing	Janice Galloway
The Trickster of Seville and His Guest of Stone	Tirso de Molina
The Triple Mirror of the Self	Zulfikar Ghose
The Twelve Lives of Samuel Hawley	Hannah Tinti
The Twilight Years	Sawako Ariyoshi
The Twins	Tessa De Loo
The Underdogs	Mariano Azuela
The Unfortunate Traveller	Thomas Nashe
The Universal Baseball Association	Robert Coover
The Unknown Soldier	Väinö Linna
The Vegetarian: A Novel	Han Kang
The Very Hungry Caterpillar	Eric Carle
The Vicar of Wakefield	Oliver Goldsmith
The Vice-Consul	Marguerite Duras
The Viceroys	Federico De Roberto
The Virgin Suicides	Jeffrey Eugenides
The Voyage of the Dawn Treader: The Chronicles of Narnia	C. S. Lewis
The Voyage Out	Virginia Woolf
The Voyages of Doctor Dolittle	Hugh Lofting
The Voyeur	Alain Robbe-Grillet
The Wanderer	Henri Alain-Fournier
The Warlord of Mars	Edgar Rice Burroughs
The Wars	Timothy Findley
The Water Dancer	Ta-Nehisi Coates
The Water Margin: Outlaws of the Marsh	Shi Naian
The Water-Babies, A Fairy Tale for a Land Baby	Charles Kingsley
The Waters of Kronos	Conrad Richter
The Way of Kings	Brandon Sanderson
The Way West	A. B. Guthrie, Jr
The Well of Loneliness	Radclyffe Hall
The Werewolf	Aksel Sandemose
The Wheel of Time Series	Robert Jordan
The White Hotel	D. M. Thomas
The White Tiger	Aravind Adiga
The Wife of Martin Guerre	Janet Lewis
The Wild Swans at Coole	William Butler Yeats
The Wind in the Willows	Kenneth Grahame
The Wind on the Moon	Eric Linklater
The Wine of Astonishment	Earl Lovelace
The Wise Man's Fear	Patrick Rothfuss
The Witness	Juan José Saer
The Woman in the Dunes	Kobo Abe
The Women's Room	Marilyn French
The Wonderful Adventures of Nils	Selma Lagerlöf
The Wonderful Wizard of Oz	L. Frank Baum
The Works of George Peele	George Peele
The Works of Walter Savage Landor	Walter Savage Landor
The Worst Witch	Jill Murphy
The Year of the French	Thomas Flanagan
The Year of the Hare	Arto Paasilinna
The Yearling	Marjorie Kinnan Rawlings
The Years with Laura Diaz	Carlos Fuentes
The Yiddish Policemen's Union	Michael Chabon
The Young Man	Botho Strauß
Theory of War	Joan Brady
Thérèse Desqueyroux	François Mauriac
Thérèse Raquin	Emile Zola
They Shoot Horses, Don't They?	Horace McCoy
This Present Darkness	Frank Peretti
This Side of Paradise	F. Scott Fitzgerald
This Way for the Gas, Ladies and Gentlemen	Tadeusz Borowski
Thomas of Reading, Or, The Sixe Worthie Yeomen of the West	Thomas Deloney
Three Junes	Julia Glass
Three Men in a Boat	Jerome K. Jerome
Three Trapped Tigers	Guillermo Cabrera Infante
Through the Language Glass: Why the World Looks Different in Other Languages	Guy Deutscher
Thursbitch	Alan Garner
Thus Spake Zarathustra	Friedrich Nietzsche
Thyestes	Seneca
Ties That Bind, Ties That Break	Lensey Namioka
Time and Again	Jack Finney
Time of Silence	Luis Martín-Santos
Time's Arrow	Martin Amis
Tinkers	Paul Harding
Tisha	Robert Specht
Tlooth	Harry Mathews
To Each His Own	Leonardo Sciascia
To Kill a Mockingbird	Harper Lee
Tobacco Road	Erskine Caldwell
Tours of the Black Clock	Steve Erickson
Track	Ernst Bloch
Tragic Magic	Wesley Brown
Trainspotting	Irvine Welsh
Tripmaster Monkey	Maxine Hong Kingston
Tristan	Gottfried von Strassburg
Tropisms	Nathalie Sarraute
Troubling Love	Elena Ferrante
True History of the Kelly Gang	Peter Carey
Twelve Bar Blues	Patrick Neate
Twilight	Stephenie Meyer
Two Essays on Analytical Psychology	Carl Jung
Two Serious Ladies	Jane Bowles
Typical: Stories	Padgett Powell
Ubu Roi	Alfred Jarry
Uncle Petros and Goldbach's Conjecture	Apostolos Doxiadis
Uncle Silas	Sheridan Le Fanu
Uncle Tom's Cabin	Harriet Beecher Stowe
Under Fire	Henri Barbusse
Under the Volcano	Malcolm Lowry
Under the Yoke	Ivan Vazov
Under Western Eyes	Joseph Conrad
Unless	Carol Shields
Untouchable	Mulk Raj Anand
Up	Ronald Sukenick
Utopia	Thomas More
V for Vendetta	Alan Moore
Valley of the Dolls	Jacqueline Susann
Vanity Fair	William Makepeace Thackeray
Vathek	William Beckford
Vendor Of Sweeets	R. K. Narayan, R. K
Venus in Furs	Leopold Von Sacher-Masoch
Vernon God Little	DBC Pierre
Victory Over Japan: A Book of Stories	Ellen Gilchrist
Vida	Marge Piercy
Vile Bodies	Evelyn Waugh
Villette	Charlotte Bronte
Visitation	Jenny Erpenbeck
Volpone	Ben Jonson
W, or the Memory of Childhood	Georges Perec
Waiting for the Dark, Waiting for the Light	Ivan Klíma
Waiting for the Mahatma	R. K. Narayan
Waiting to Exhale	Terry McMillan
Walden Two	B. F. Skinner
War Dances	Sherman Alexie
War Music	Christopher Logue
War Poems of Siegfried Sassoon	Siegfried Sassoon
War Trash	Ha Jin
Watchers	Dean R. Koontz
Watchmen	Alan Moore, Dave Gibbons
Waterland	Graham Swift
Watership Down	Richard Adams
Watt	Samuel Beckett
Waverley	Sir Walter Scott
We	Yevgeny Zamyatin
We are All Completely Beside Ourselves	Karen Joy Fowler
We're Going on a Bear Hunt	Michael Rosen
What a Carve Up!	Jonathan Coe
What Belongs to You	Garth Greenwell
Whatever	Michel Houellebecq
Where Angels Fear to Tread	E. M. Forster
Where the Red Fern Grows	Wilson Rawls
Where the Sidewalk Ends	Shel Silverstein
White Girls	Hilton Als
Who Fears Death	Nnedi Okorafor
Wide Sargasso Sea	Jean Rhys
Wild at Heart: The Story of Sailor and Lula	Barry Gifford
Wilhelm Meister's Apprenticeship	Johann Wolfgang von Goethe
Will You Please be Quiet, Please?	Raymond Carver
Willard and His Bowling Trophies: A Perverse Mystery	Richard Brautigan
Winesburg, Ohio	Sherwood Anderson
Winter's Bone	Daniel Woodrell
Winter's Tale	Mark Helprin
Wittgenstein's Mistress	David Markson
Wolf Brother	Michelle Paver
Wolf in White Van	John Darnielle
Woman at Point Zero	Nawal El Saadawi
Women	Charles Bukowski
Women in Their Beds	Gina Berriault
Words	Jacques Prévert
Works and Days	Hesiod
World's Fair	E. L. Doctorow
Wry-Blue Loves: Les Amours Jaunes	Tristan Corbière
Years of Grace	Margaret Ayer Barnes
Yellow Back Radio Broke-Down	Ishmael Reed
You Bright and Risen Angels	William T. Vollmann
You Shall Know Our Velocity	Dave Eggers
Young Shoulders	John Wain
Youth	J M Coetzee
Z	Vassilis Vassilikos
Zuleika Dobson	Max Beerbohm